0 1 - - -
1 2 0 - 7
2 - 1 3 -
3 - - 4 2
4 5 - - 3
5 - 4 6 -
6 - 9 - 5
7 - 8 1 -
8 7 - - -
9 6 - - -
M 1 2 3 4